......................
......................
......................
......................
......................
.........####.........
........#    #........
........#    #........
........#    #........
.........####.........
......................
......................
......................
......................
..........0...........