.......................
.......................
.......................
.......................
.......................
.........#####.........
........#     #........
........#     #........
........#     #........
.........#####.........
.......................
.......................
.......................
.......................
..........0............