...................
..............#....
...############....
...#........###....
...#..........#....
...#..........#....
0.............#....
...#..........#....
...#...#......#....
...#..........#....
...#..........#..##
..#######.#####....
...................
.........1.........